# ===================================================================================================== #
#    ________                                       _____  __________                              	#
#   /  _____/_____    _____   ____   ______   _____/ ____\ \______   \ ____   ____   _____   ______     #
#  /   \  ___\__  \  /     \_/ __ \ /  ___/  /  _ \   __\   |       _//  _ \ /  _ \ /     \ /  ___/     #
#  \    \_\  \/ __ \|  Y Y  \  ___/ \___ \  (  <_> )  |     |    |   (  <_> |  <_> )  Y Y  \\___ \      #
#   \______  (____  /__|_|  /\___  >____  >  \____/|__|     |____|_  /\____/ \____/|__|_|  /____  >     #
#          \/     \/      \/     \/     \/                         \/                    \/     \/      #
# ===================================================================================================== #
